
MMMMMMMMMMMMMMMMMMMMMMMMM
MCCCMMMMMMVCMMMMMMMMMMMMM
MCCCCCCMMMCCCCCCCCMMMPVPM
MCCCCCCCMMCCCCCCCCMMMCCCM
MMMMMMCCMMMCCMMMCCMMCCCMM
MPPPPMCCCCCCCMMMCCMCCCCMM
MCCCCMCCCGCCCMMMCCMCCCCMM
MCCCCMMMMMMMMMMMCCMMMMCMM
MVVCCMMMMMMMMMCCCCMMOCCCM
MMMCCCMMMMMMMMCCCCCCCCCCM
MMMMCCMMMMMMMMCCCCCCCCCCM
MMMMCCVVPVPPMMMMMMMMCCCCM
MMMMCCCCCCCCCCCCCMMMCCCCM
MMMMCCCOCCCGCCCCCMMMMCCMM
MMMMCCCCCCCCMMMCCMMMMCCMM
MMMMCCMMMMMMMMCCCCCMMCCVM
MCCCCCMMMMMMMMCCOCCMMCCMM
MCCCCCMMMMVTVMCCCCCMMCCMM
MCCCCCMMMMCCCMCCCCCMMCCPM
MCCMMMMMCCCCCMVCCCPMMCCMM
MCCMMMMCCCCCCMMMCCMMMCCMM
MCCMMMMCCOCCCMMMCCCCCCCVM
MCCCCCCCCCCCCMMMMMMMCCCCM
MCCCCCCCCCCCCMMMMMMMCGCCM
MMMMMMMMMMMMMMMMMMMMMMMMM