
MMMMMMMMMMMMMMMMMMMMMMMMM
MCCCMMMMMMMMMMMMMMMMMMMMM
MCCCMMMMMMMMMMMMMMMMMMMMM
MCCCMMMMMMMMMMMMMCCCCCCCM
MMCCMMMMMMMMMMMMMCCCCMMTM
MMCCMMMMMMMMMMCCCOCCCMMVM
MMMCMMMMMMMMMMCCCCCCCCCCM
MMMCMMVMVMMMMMCCMCCCCCCCM
MMCCCCCCCCMMMMCCMMMMMMMMM
MCCCCCCCCCCCCMCCMMMMMMMMM
MCCCCCCCCCCCCMCCMMMMMMMMM
MCMCCCOCCCMCCMCCCCCCCCCCM
MCMMMMMMMCMMCMMMCCMMMMMCM
MCMMMMMMMMMMCMCCCCMMMMMOM
MCCCCMCVMCCCCMCCCCCCCCCCM
MCCCCCCCCCCCCMCCMMMMMMMMM
MMMCCCCCCCMMMMCCCCCCCMMMM
MMMCGCCCCCMMMMMMMMMCCMMMM
MMMMMMCCMMMMMMMMMMMCCMMMM
MMMMMMCCMMMMCCMMMCMCCMMMM
MMMMMMCCMMMMCCCCCCCCMMMMM
MMMMCCCCCMMMCCCCOCCCMMMMM
MMCCCCCCCMMMCCCCCCCCMMMMM
MMCCCCCCCCCCCMCVCVMMMMMMM
MMMMMMMMMMMMMMMMMMMMMMMMM