
MMMMMMMMMMMMMMMMMMMMMMMMM
MCCCCMCCCCCCCCCCCCCCCCCCM
MCCCCCCCCCCCCCCCCCCCCCCCM
MCCCCCCCCCCCCCCCCCCCCCCCM
MMMMMMMMMMMMMMMMMCCCCCCCM
MCCCCCCCCCCCCCCCMCCCCCCCM
MCCCCCCCCCCCCCCCMCCCCCCCM
MCCCCCMMMCCCCCCCMCCCCCCCM
MCCCCCMMMCCCCCCCCCCCCCCCM
MCCCCCMMMCCCCCCCCCCCCCCCM
MCCCCCCGCCCCCCCCMCCCCCCCM
MCCCCCCCCCCCCCCCMCCCCCCCM
MMMMMMCCCCMMMMMMMCCCCCCCM
MCCCCCCCCCCCCCCCMCCCCCCCM
MCCCCCCCCCCCCCCCMCCCCCCCM
MCCCCCCCCCCCCCCCMCCCCCCCM
MCCCCCCCCCCCCCCCMCCCGCCCM
MCCCCCCCCCMMMMMMMMMMMMMMM
MCCCCCCCCCMCCCCCCCCCCCCCM
MCCCCCOCCCMCCCCCCCCCCCCCM
MCCCCCCCCCCCCCCCCCCCCTCCM
MCCCCCCCCCCCCCCCCCCCCCCCM
MCCCCCCCCCMCCCCCCCCCCCCCM
MCCCCCCCCCMCCCCCCCCCCCCCM
MMMMMMMMMMMMMMMMMMMMMMMMM