
MMMMMMMMMMMMMMMMMMMMMMMMM
MCCCMTCCCCCCCCOCCCCCCCCCM
MCCCMMMMVVVCCCOCCCCCCCCCM
MCCCCCCMMMMMMMMMCCCCCCCCM
MMMMMCCMMMVVVVVMCCCCCCCCM
MCCCCCCCCCCCCCMMCCCCCCCCM
MCCCCCCCCCCCCCMCCCCCCCCCM
MCCCCCCCCCCCCCMMMMCCCCCCM
MCCCOCCCCOCCCCCCCMCCCCCCM
MCCCCCCCCCCCCCCCCMCCCCCCM
MCCCCCCCCCCCCCMCCMCCOCCCM
MMMMMMMMMMMMMMMCCMCCCCCCM
MCCCVPPPPPVVVPMCCMCCCCCCM
MCCCCCCCCCCCCCCCCMCCOCCCM
MCCCCCCCCCCCCCCCCMCCCCCCM
MCCCCCGCCCCCCCMMMMCCCCCCM
MCCCOCCCCOCCCCMCCCCCCCCCM
MCCCCCCCCCCCCCMCCCCCCCCCM
MCCCCMMMMMMMMMMCCCCCGCCCM
MCCCCCCCCVVVVVMCCCCCCCCCM
MCCCCCCCOCCCCCCCCCCCCCCCM
MCCCCCOCCCCCCCCCCCCCCCCCM
MCCCCCCCCCCCCCMMMMMCCMMMM
MCCCCCCCOCCCCCMPPPPPPPPPM
MMMMMMMMMMMMMMMMMMMMMMMMM