
MMMMMMMMMMMMMMMMMMMMMMMMM
MCCCMMMMMMCCMMMMMMMMMMMMM
MCCCCCCCMMCCCCCCCCMMMCCCM
MCCCCCCCMMCCCCCCCCMMMCCCM
MMMMMMCCMMMCCMMMCCMMCCCMM
MCCCCMCCCCCCCMMMCCMCCCCMM
MCCCCMCCCCCCCMMMCCMCCCCMM
MCCCCMMMMMMMMMMMCCMMMMCMM
MCCCCMMMMMMMMMCCCCMMCCCCM
MMMCCCMMMMMMMMCCCCCCCCCCM
MMMMCCMMMMMMMMCCCCCCCCCCM
MMMMCCCCCCCCMMMMMMMMCCCCM
MMMMCCCCCCCCCCCCCMMMCCCCM
MMMMCCCCCCCCCCCCCMMMMCCMM
MMMMCCCCCCCCMMMCCMMMMCCMM
MMMMCCMMMMMMMMCCCCCMMCCCM
MCCCCCMMMMMMMMCCCCCMMCCMM
MCCCCCMMMMCTCMCCCCCMMCCMM
MCCCCCMMMMCCCMCCCCCMMCCCM
MCCMMMMMCCCCCMCCCCCMMCCMM
MCCMMMMCCCCCCMMMCCMMMCCMM
MCCMMMMCCCCCCMMMCCCCCCCCM
MCCCCCCCCCCCCMMMMMMMCCCCM
MCCCCCCCCCCCCMMMMMMMCCCCM
MMMMMMMMMMMMMMMMMMMMMMMMM