MMMMMMMMMMMMMMMMMMMMMMMMM
MCCCCCCCCMCCCCCCCCCCMCCCM
MCCCMMMCCMCCCCMMMMCCMCCCM
MCCCCCMCCMCCCCMCCCCCMCMCM
MMMMMCMCCMCCCCMCCCCMMCMCM
MCCCCCMCCMMMMMMCCCCMCCMCM
MCCCCCMCCCCCCCCCCCCMCMMCM
MCCMMMMMMMMMMCCCCCCMCMCCM
MCCMCCMCCMCCCCCCCCCMCMCCM
MCCMCCMCCMCCCCCCCMMMCMCCM
MCCMCCMCCMCCCCCCCMCCCMCCM
MCCCCCMCCMCCCCCCCCCMMMCCM
MCCCCCMCCMCCCCCMMMMMCCCCM
MMMCCCMCCMMMMMMMCCCCCCCCM
MCCCCCCCCMCCCCCMCCCMCCCCM
MCCMMMMMMMCCMCCMCCCMCMCCM
MCCCCCCCCCCCMCCMCCCMCMCCM
MMMMMMMMMMMMMCCMCCCMCMCCM
MCCCCCCCMCCCMCCMCCMMCMCCM
MCCCCCCCCCMCCCCMCCMCCMCCM
MCCCCMCCCCMMMMMMCCMMMMCCM
MCCCCMCMCCMCCCCMCCCCCMCCM
MCCCCMMMMMMMCCMMCCCCCMMMM
MCCCCCCCCCCCCCCCCCCCCCCTM
MMMMMMMMMMMMMMMMMMMMMMMMM