
MMMMMMMMMMMMMMMMMMMMMMMMM
MCCCMMMMMMMMMMMMMMMMMMMMM
MCCCMMMMMMMMMMMMMMMMMMMMM
MCCCMMMMMMMMMMMMMCCCCCCCM
MMCCMMMMMMMMMMMMMCCCCMMTM
MMCCMMMMMMMMMMCCCCCCCMMCM
MMMCMMMMMMMMMMCCCCCCCCCCM
MMMCMMCMCMMMMMCCMCCCCCCCM
MMCCCCCCCCMMMMCCMMMMMMMMM
MCCCCCCCCCCCCMCCMMMMMMMMM
MCCCCCCCCCCCCMCCMMMMMMMMM
MCMCCCCCCCMCCMCCCCCCCCCCM
MCMMMMMMMCMMCMMMCCMMMMMCM
MCMMMMMMMMMMCMCCCCMMMMMCM
MCCCCMCCMCCCCMCCCCCCCCCCM
MCCCCCCCCCCCCMCCMMMMMMMMM
MMMCCCCCCCMMMMCCCCCCCMMMM
MMMCCCCCCCMMMMMMMMMCCMMMM
MMMMMMCCMMMMMMMMMMMCCMMMM
MMMMMMCCMMMMCCMMMCMCCMMMM
MMMMMMCCMMMMCCCCCCCCMMMMM
MMMMCCCCCMMMCCCCCCCCMMMMM
MMCCCCCCCMMMCCCCCCCCMMMMM
MMCCCCCCCCCCCMCCCCMMMMMMM
MMMMMMMMMMMMMMMMMMMMMMMMM