MMMMMMMMMMMMMMMMMMMMMMMMMMMMMM
MCCCCCCCCCCCCCCCCCCCCCCCCCCCCM
MCCCCCCCCCCCCCCCCCCCCCCcCCCCCM
MCCCCCCCCCCCCCCCCCCCCCCCCCCCCM
MCCCCCCCCCCCCCCCCCCCCCCCCCCCCM
MCCCCCCCCCCCCCCCCCCCCCCCCCCCCM
MCCCCCCCCCCCCCCCCCCCCCCCCCCCCM
MCCCCCCCCCCCCCCCCCCCCCCCCCCCCM
MCCCCCCCCCCCCCCCCCCCCCCCCCCCCM
MCCCCCCCCCCCCCCCCCCCCCCCCCCCCM
MCCCCCCCCCCCCCCCCCCCCCCCCCCCCM
MCCCCCCCCCCCCCCCCCCCCCCCCCCCCM
MCCCCCCCCCCCCCCCCCCCCCCCCCCCCM
MCCCCCCCCCCCCCCCCCCCCCCCCCCCCM
MCCCCCCCCCCCCCCCCCCCCCCCCCCCCM
MCCCCCCCCCCCCCCCCCCCCCCCCCCCCM
MCCCCCCCCCCCCCCCCCCCCCCCCCCCCM
MCCCCCCCCCCCCCCCCCCCCCCCCCCCCM
MCCCCCCCCCCCCCCCCCCCCCCCCCCCCM
MCCCCCCCCCCCCCCCCCCCCCCCCCCCCM
MCCCCCCCCCCCCCCCCCCCCCCCCCCCCM
MCCCCCCCCCCCCCCCCCCCCCCCCCCCCM
MCCCCCCCCCCCCCCCCCCCCCCCCCCCCM
MCCCCCCCCCCCCCCCCCCCCCCTCCCCCM
MCCCCCCCCCCCCCCCCCCCCCCCCCCCCM
MCCCCCCCCCCCCCCCCCCCCCCCCCCCCM
MCCCCCCCCCCCCCCCCCCCCCCCCCCCCM
MCCCCCCCCCCCCCCCCCCCCCCCCCCCCM
MCCCCCCCCCCCCCCCCCCCCCCCCCCCCM
MMMMMMMMMMMMMMMMMMMMMMMMMMMMMM