
MMMMMMMMMMMMMMMM
MCCCMCCCCCCCCCCM
MCCCMCCCCCCCCCCM
MCCCCCCCCCCCCCCM
MMMMMMMMMMCCMMMM
MCCCCCCCCCCCCCCM
MCCCCCCCCCCCCCCM
MCCCCCCCCMMMMMMM
MCCCCCCCCMCCCCCM
MCCMMMMMMMCCCCGM
MCCCCCCCCMCCCCCM
MCCCCCCCCMCCCCCM
MMMMMMMCCMCCMMMM
MCCCCCCCCCCCCCCM
MCCCCCCCCCCCCCCM
MMMMMMMMMMMMMMMM