
MMMMMMMMMMMMMMMMMMMMMMMMM
MCCCCCCCCCCCCCCCCCCCCCCCM
MCCCCCCCCCCCCCCCCCCCCCCCM
MCCCCCCCCCCCCCCCCCCCCCCCM
MCCCCCCCCCCCCCCCCCCCCCCCM
MCCCCCCCCCCCCCCCCCCCCCCCM
MCCCCCCCCCCCCCCCCCCCCCCCM
MCCCCCCCCCCCCCCCCCCCCCCCM
MCCCCCCCCCCCCCCCCCCCCCCCM
MCCCCCCCCCCCCCCCCCCCCCCCM
MCCCCCCCCCCCCCCCCCCCCCCCM
MCCCCCCCCCCCCCCCCCCCCCCCM
MCCCCCCCCCCCCCCCCCCCCTCCM
MCCCCCCCCCCCCCCCCCCCCCCCM
MCCCCCCCCCCCCCCCCCCCCCCCM
MCCCCCCCCCCCCCCCCCCCCCCCM
MCCCCCCCCCCCCCCCCCCCCCCCM
MCCCCCCCCCCCCCCCCCCCCCCCM
MCCCCCCCCCCCCCCCCCCCCCCCM
MCCCCCCCCCCCCCCCCCCCCCCCM
MCCCCCCCCCCCCCCCCCCCCCCCM
MCCCCCCCCCCCCCCCCCCCCCCCM
MCCCCCCCCCCCCCCCCCCCCCCCM
MCCCCCCCCCCCCCCCCCCCCCCCM
MMMMMMMMMMMMMMMMMMMMMMMMM