
MMMMMMMMMMMMMMMMMMMMMMMMM
MCCCMCCCCCCCCCCCMCCCCCCCM
MCCCCCCCCCMMMCCCMCCCCCCCM
MCCCCCCCCCCCMCCCMCCCCCCCM
MMMMMMMMMMMMMCCCMCCMMCCCM
MCCCCCCCCCCCCCCCMCCMCCCCM
MCCCCCMMMMMMMMMMMCCMCCCCM
MCCCCCCMMMMMCCCCCCCMCCCCM
MCCCCMCMCCCCCMMMMMMMCCCCM
MCCCCMCMTCCCMMCCCCCCCCCCM
MCCCCMCMMMMMMCCCCCCCCCCCM
MCCCCMCCCCCCMCCCCCCCCCCCM
MCCCCMCCCCCCMMMMMMMCCMMMM
MCCMMMMMCCCCCCCCCMCCCCCCM
MCCMMCMMCCCCMMMMMMCCCCCCM
MCCCCCCCCCCCMMMMMMCCCCCCM
MCCCCCCCCCCCCCCCCMCCCCCCM
MMMMMMMMMMMMMMCCCMCCCCCCM
MCCCCCCCCCCCCMCCCMCCCCCCM
MCCCCCCCCCCCCCCCCMCCCCCCM
MMMMMCCCMMMMMMMMMMMMCCCCM
MCCCCCCCMCCCCCCCCCCCCCCCM
MCCCCCCCMCCCCCCCCCCCCCCCM
MCCCCCCCCCCCCCCCCCCCCCCCM
MMMMMMMMMMMMMMMMMMMMMMMMM