MMMMMMMMMMMMMMMMMMMMMMMMMMMMMMMMMMM
MCCCCCCCCMCCCCCCCCCCMCCCMMMMMMMMMMM
MCCCMMMCCMCCCCMMMMCCMCCCMMMMMMMMMMM
MCCCCCMCCMCCCCMCCCCCMCMCMMMMMMMMMMM
MCCCCCMCCMCCCCMCCCCMMCMCMMMMMMMMMMM
MCCCCCMCCMMMMMMCCCCMCCMCMMMMMMMMMMM
MCCCCCMCCCCCCCCCCCCMCMMCMMMMMMMMMMM
MCCMMMMMMMMMMCCCCCCMCMCCMMMMMMMMMMM
MCCMCCMCCMCCCCCCCCCMCMCCMMMMMMMMMMM
MCCMCCMCCMCCCCCCCMMMCMCCMMMMMMMMMMM
MCCMCCMCCMCCCCCCCMCCCMCCMMMMMMMMMMM
MCCCCCMCCMCCCCCCCCCMMMCCMMMMMMMMMMM
MCCCCCMCCMCCCCCMMMMMCCCCMMMMMMMMMMM
MMMCCCMCCMMMMMMMCCCCCCCCMMMMMMMMMMM
MCCCCCCCCMCCCCCMCCCMCCCCMMMMMMMMMMM
MCCMMMMMMMCCMCCMCCCMCMCCMMMMMMMMMMM
MCCCCCCCCCCCMCCMCCCMCMCCMMMMMMMMMMM
MMMMMMMMMMMMMCCMCCCMCMCCMMMMMMMMMMM
MCCCCCCCMCCCMCCMCCMMCMCCMMMMMMMMMMM
MCCCCCCCCCMCCCCMCCMCCMCCMMMMMMMMMMM
MCCCCMCCCCMMMMMMCCMMMMCCMMMMMMMMMMM
MCCCCMCMCCMCCCCMCCCCCMCCMMMMMMMMMMM
MCCCCMMMMMMMCCMMCCCCCMMMMMMMMMMMMMM
MCCCCMMMMMMMCCMMCCCCCMMMMMMMMMMMMMM
MCCCCMMMMMMMCCMMCCCCCMMMMMMMMMMMMMM
MCCCCMMMMMMMCCMMCCCCCMMMMMMMMMMMMMM
MCCCCMMMMMMMCCMMCCCCCMMMMMMMMMMMMMM
MCCCCMMMMMMMCCMMCCCCCMMMMMMMMMMMMMM
MCCCCMMMMMMMCCMMCCCCCMMMMMMMMMMMMMM
MCCCCMMMMMMMCCMMCCCCCMMMMMMMMMMMMMM
MCCCCMMMMMMMCCMMCCCCCMMMMMMMMMMMMMM
MCCCCMMMMMMMCCMMCCCCCMMMMMMMMMMMMMM
MCCCCMMMMMMMCCMMCCCCCMMMMMMMMMMMMMM
MCCCCCCCCCCCCCCCCCCCCCCTMMMMMMMMMMM
MMMMMMMMMMMMMMMMMMMMMMMMMMMMMMMMMMM